#######
#     #
# .$ @#
#     #
#######