


#############################
#                           #
#                           #
#                           #
#     @$                .   #
#                           #
#                           #
#                           #
#############################


