
#####################
#         #         #
 #       .#$       #
  #       #       #
   #     #       #
    #   #       #
     #   ##    #
     ## ##### ##
     #    #    #
     #    @    #
     #    #    #
     ###########

