
  ######
###    ###
#   .#   #
#  $.$ # #
#  #* $  #
# *..   ##
# $#$@  #
# *..  ##
#  #$ ##
##    #
 ######