
    #########
    #       #
    #       #
    # $$$$$ #
    ##     ##
#######   #######
#  . #     # .  #
#  .   # #   .  #
#  .    @    .  #
#  .   # #   .  #
#  . #     # .  #
#######   #######
    ##     ##
    # $$$$$ #
    #       #
    #       #
    #########