#################
#               #
#       .       #
#               #
#  .    @    $  #
#               #
#       $       #
#               #
#################

