######
#    #
# .$@#
#    #
######
