#######
#     #
# . $@#
#     #
#######
