#########
#      .#
#  .$  $#
#  $$@  #
#   .   #
#     . #
#########