#####
# @ #
#   #
# $ #
# . #
#####