     ####
  ####  #
  #@$ $ #
### .#. #
# $$.## ##
#  $...  #
#    #$# #
######   #
     #####